
           NO textures/wall0.xpm
SO textures/wall1.xpm
WE textures/wall3.xpm
    F   80, 50, 30 
EA textures/wall2.xpm

   C  90, 90, 100

                   1111111111111111111111111
                    1000000000110000000000001
                   1011000001110000000000001
                   1001000000000000000000001
111111111111111111111011000001110000000000001
1000000000110000011101111101111111111111111111
11110111111111011100000010001
11110111111111011101010010001
11000000110101011100000010001                                                                              
10000000000000001100000010001
10000000000000001101010010001
11000001110101011111011110N0111
11110111 1110101 101111010001
11111111 1111111 111111111111